USD - US Dollar
EUR - Euro
GBP - British Pound
CAD - Canadian Dollar
AUD - Australian Dollar
JPY - Japanese Yen
ADA - Cardano
AED - Emirati Dirham
AFN - Afghan Afghani
ALL - Albanian Lek
AMD - Armenian Dram
ANG - Dutch Guilder
AOA - Angolan Kwanza
ARS - Argentine Peso
AUD - Australian Dollar
AWG - Aruban or Dutch Guilder
AZN - Azerbaijan Manat
BAM - Bosnian Convertible Mark
BBD - Barbadian or Bajan Dollar
BCH - Bitcoin Cash
BDT - Bangladeshi Taka
BGN - Bulgarian Lev
BHD - Bahraini Dinar
BIF - Burundian Franc
BMD - Bermudian Dollar
BND - Bruneian Dollar
BOB - Bolivian Bolíviano
BRL - Brazilian Real
BSD - Bahamian Dollar
BTC - Bitcoin
BTN - Bhutanese Ngultrum
BWP - Botswana Pula
BYN - Belarusian Ruble
BYR - Belarusian Ruble
BZD - Belizean Dollar
CAD - Canadian Dollar
CDF - Congolese Franc
CHF - Swiss Franc
CLP - Chilean Peso
CNY - Chinese Yuan Renminbi
COP - Colombian Peso
CRC - Costa Rican Colon
CUC - Cuban Convertible Peso
CUP - Cuban Peso
CVE - Cape Verdean Escudo
CZK - Czech Koruna
DJF - Djiboutian Franc
DKK - Danish Krone
DOGE - Dogecoin
DOP - Dominican Peso
DOT - Polkadot
DZD - Algerian Dinar
EEK - Estonian Kroon
EGP - Egyptian Pound
ERN - Eritrean Nakfa
ETB - Ethiopian Birr
ETH - Ethereum
EUR - Euro
FJD - Fijian Dollar
FKP - Falkland Island Pound
GBP - British Pound
GEL - Georgian Lari
GGP - Guernsey Pound
GHS - Ghanaian Cedi
GIP - Gibraltar Pound
GMD - Gambian Dalasi
GNF - Guinean Franc
GTQ - Guatemalan Quetzal
GYD - Guyanese Dollar
HKD - Hong Kong Dollar
HNL - Honduran Lempira
HRK - Croatian Kuna
HTG - Haitian Gourde
HUF - Hungarian Forint
IDR - Indonesian Rupiah
ILS - Israeli Shekel
IMP - Isle of Man Pound
INR - Indian Rupee
IQD - Iraqi Dinar
IRR - Iranian Rial
ISK - Icelandic Krona
JEP - Jersey Pound
JMD - Jamaican Dollar
JOD - Jordanian Dinar
JPY - Japanese Yen
KES - Kenyan Shilling
KGS - Kyrgyzstani Som
KHR - Cambodian Riel
KMF - Comorian Franc
KPW - North Korean Won
KRW - South Korean Won
KWD - Kuwaiti Dinar
KYD - Caymanian Dollar
KZT - Kazakhstani Tenge
LAK - Lao Kip
LBP - Lebanese Pound
LINK - Chainlink
LKR - Sri Lankan Rupee
LRD - Liberian Dollar
LSL - Basotho Loti
LTC - Litecoin
LTL - Lithuanian Litas
LUNA - Terra
LVL - Latvian Lat
LYD - Libyan Dinar
MAD - Moroccan Dirham
MDL - Moldovan Leu
MGA - Malagasy Ariary
MKD - Macedonian Denar
MMK - Burmese Kyat
MNT - Mongolian Tughrik
MOP - Macau Pataca
MRU - Mauritanian Ouguiya
MUR - Mauritian Rupee
MVR - Maldivian Rufiyaa
MWK - Malawian Kwacha
MXN - Mexican Peso
MYR - Malaysian Ringgit
MZN - Mozambican Metical
NAD - Namibian Dollar
NGN - Nigerian Naira
NIO - Nicaraguan Cordoba
NOK - Norwegian Krone
NPR - Nepalese Rupee
NZD - New Zealand Dollar
OMR - Omani Rial
PAB - Panamanian Balboa
PEN - Peruvian Sol
PGK - Papua New Guinean Kina
PHP - Philippine Peso
PKR - Pakistani Rupee
PLN - Polish Zloty
PYG - Paraguayan Guarani
QAR - Qatari Riyal
RON - Romanian Leu
RSD - Serbian Dinar
RUB - Russian Ruble
RWF - Rwandan Franc
SAR - Saudi Arabian Riyal
SBD - Solomon Islander Dollar
SCR - Seychellois Rupee
SDG - Sudanese Pound
SEK - Swedish Krona
SGD - Singapore Dollar
SHP - Saint Helenian Pound
SLE - Sierra Leonean Leone
SLL - Sierra Leonean Leone
SOS - Somali Shilling
SPL - Seborgan Luigino
SRD - Surinamese Dollar
STN - Sao Tomean Dobra
SVC - Salvadoran Colon
SYP - Syrian Pound
SZL - Swazi Lilangeni
THB - Thai Baht
TJS - Tajikistani Somoni
TMT - Turkmenistani Manat
TND - Tunisian Dinar
TOP - Tongan Pa'anga
TRY - Turkish Lira
TTD - Trinidadian Dollar
TVD - Tuvaluan Dollar
TWD - Taiwan New Dollar
TZS - Tanzanian Shilling
UAH - Ukrainian Hryvnia
UGX - Ugandan Shilling
UNI - Uniswap
USD - US Dollar
UYU - Uruguayan Peso
UZS - Uzbekistani Som
VEF - Venezuelan Bolívar
VES - Venezuelan Bolívar
VND - Vietnamese Dong
VUV - Ni-Vanuatu Vatu
WST - Samoan Tala
XAF - Central African CFA Franc BEAC
XAG - Silver Ounce
XAU - Gold Ounce
XCD - East Caribbean Dollar
XDR - IMF Special Drawing Rights
XLM - Stellar Lumen
XOF - CFA Franc
XPD - Palladium Ounce
XPF - CFP Franc
XPT - Platinum Ounce
XRP - Ripple
YER - Yemeni Rial
ZAR - South African Rand
ZMK - Zambian Kwacha
ZMW - Zambian Kwacha
ZWD - Zimbabwean Dollar
